█████████████████████████████████████
█                       █   █     █ █
█ ███████ █████████████ █ █ █ ███ █ █
█   █   █ █           █ █ █   █     █
█ █ ███ █ ███████████ ███ ███ █████ █
█ █   █   █       █   █   █   █   █ █
█ ███ █ ███████ ███ ███ ███████ █ █ █
█ █   █ █     █ █   █           █ █ █
███ ███ █ ███ █ █ ███ ███████████ █ █
█   █     █ █ █ █ █ █ █           █ █
█ █████████ █ █ █ █ █ █ ███████████ █
█       █       █ █   █ █           █
█ █████ █ ███████ █████ █ ███████████
█ █     █   █   █       █           █
█ █ █ ███████ █ ███████████████████ █
█ █ █ █       █   █ █     █       █ █
█ █ ███ ███████ █ █ █ ███ █ █████ █ █
█ █   █ █   █   █   █ █ █ █ █ █   █ █
█ ███ █ █ █ █ ███████ █ █ █ █ █ ███ █
█   █ █ █ █ █       █   █   █ █   █ █
█████ █ ███ ███████ ███ █████ ███ █ █
█     █   █       █ █   █       █ █ █
█ ███████ ███ ███ █ █ ███ ███ ███ █ █
█     █   █   █   █ █ █   █   █   █ █
█ ███ █ ███ ███████ █ █ █ █████ █ █ █
█   █   █     █     █ █ █ █     █ █ █
███ █████████ █ █████ █ ███ █ █████ █
█   █       █ █ █   █ █   █ █ █   █ █
█ ███████ █ █ █ █ █ █ ███ █ ███ █ █ █
█         █   █   █       █     █   █
█████████████████████████████████████
