11011111111111111
10011111111101111
10010111111000111
11010111111100111
11000111111100111
10011110001100111
10000000001110001
11111101111110111
11111101111000111
10001101110001111
10101101110101111
10101101110101111
10101101110101111
10001101111101111
11011101111101111
11000000000001111
11111111111101111
